#,#,#,#,#,#,#,#,#,#,#,#,#,#,#,#,#,#,#,#,#,#,#,#,#,#,#,#,#,#,#,#,#,#,#,#,#,#,#,#,#,#,#,#,#,#,#,#
#,*,*,*,*,*,*,#,*,*,*,*,*,*,*,*,*,*,*,*,*,*,*,*,*,*,*,*,*,*,*,*,*,*,*,*,*,*,^,*,*,*,*,*,*,*,*,#
#,*,*,*,*,*,*,#,#,#,*,*,*,*,*,*,^,*,*,*,*,*,*,*,#,#,#,#,#,#,#,#,#,#,#,#,#,#,#,#,#,#,#,#,*,*,*,#
#,*,*,*,*,*,*,*,*,#,*,*,*,*,*,*,*,*,*,*,*,*,*,*,#,#,#,#,#,#,#,#,#,#,#,#,#,#,#,#,#,#,#,#,*,*,*,#
#,*,*,*,*,*,*,*,*,#,#,#,*,*,*,*,*,*,*,#,#,#,#,#,#,#,#,#,#,#,#,#,#,#,#,#,#,#,#,#,#,#,#,#,*,*,*,#
#,*,*,*,*,*,*,*,*,*,*,#,*,*,*,*,*,*,*,#,#,#,*,*,#,#,#,#,#,#,#,#,#,#,#,#,#,#,#,#,#,#,#,#,*,*,*,#
#,*,*,*,*,*,*,*,*,*,*,#,*,*,*,*,*,*,*,#,*,*,*,*,#,#,#,#,#,#,#,#,#,#,#,#,#,#,#,#,#,#,#,#,*,*,*,#
#,*,*,*,#,#,#,#,#,#,#,#,*,*,*,*,*,*,*,#,*,*,*,*,#,#,#,#,#,#,#,#,#,#,#,#,#,#,#,#,#,#,#,#,*,*,*,#
#,*,*,*,#,#,#,*,*,*,*,#,*,*,*,*,*,*,*,#,*,*,*,*,#,#,#,#,#,#,#,#,#,#,#,#,#,#,#,#,#,#,#,#,*,*,*,#
#,*,*,*,#,#,#,*,*,*,*,#,*,*,*,*,*,*,*,#,*,*,*,*,#,#,#,#,#,#,#,#,#,#,#,#,#,#,#,#,#,#,#,#,*,^,*,#
#,*,*,*,*,*,*,*,*,*,*,#,*,*,*,*,*,*,*,#,*,*,*,*,#,#,#,#,#,#,#,#,#,#,#,#,#,#,#,#,#,#,#,#,*,*,*,#
#,*,*,*,*,*,*,*,*,*,*,#,*,*,*,*,*,*,*,#,*,*,*,*,#,#,#,#,#,#,#,#,#,#,#,#,#,#,#,#,#,#,#,#,*,*,*,#
#,*,*,*,*,*,*,*,*,*,*,#,*,*,*,*,*,*,*,#,*,*,*,*,#,#,#,#,#,#,#,#,#,#,#,#,#,#,#,#,#,#,#,#,*,*,*,#
#,*,*,*,*,*,#,#,#,#,#,#,#,#,#,#,#,*,*,#,*,*,*,*,#,#,#,#,#,#,#,#,#,#,#,#,#,#,#,#,#,#,#,#,*,*,*,#
#,*,*,*,*,*,#,*,*,*,*,*,*,*,*,*,*,*,*,#,*,*,*,*,#,#,#,#,#,#,#,#,#,#,#,#,#,#,#,#,#,#,#,#,*,*,*,#
#,*,*,*,*,*,#,*,*,*,*,*,*,*,*,*,*,*,*,#,#,*,*,*,#,#,#,#,#,#,#,#,#,#,#,#,#,#,#,#,#,#,#,#,*,*,*,#
#,*,*,*,*,*,#,*,*,*,*,*,*,*,*,*,*,*,*,#,*,*,*,*,#,#,#,#,#,#,#,#,#,#,#,#,#,#,#,#,#,#,#,#,*,*,*,#
#,*,*,*,*,*,#,*,*,*,*,*,*,*,*,*,*,*,*,#,*,*,*,*,#,#,#,#,#,#,#,#,#,#,#,#,#,#,#,#,#,#,#,#,*,*,*,#
#,*,*,*,*,*,#,*,*,*,*,*,*,*,*,^,*,*,*,#,*,*,*,*,#,#,#,#,#,#,#,#,#,#,#,#,#,#,#,#,#,#,#,#,*,*,*,#
#,*,*,*,*,*,#,*,*,*,*,*,*,*,*,*,*,*,*,#,*,*,*,*,#,#,#,#,#,#,#,#,#,#,#,#,#,#,#,#,#,#,#,#,*,*,*,#
#,*,*,*,*,*,#,*,*,*,*,*,*,*,*,*,*,*,*,#,*,*,*,*,#,#,#,#,#,#,#,#,#,#,#,#,#,#,#,#,#,#,#,#,*,*,*,#
#,*,*,*,*,*,#,*,*,*,*,*,*,*,*,*,*,*,*,#,*,*,^,*,#,#,#,#,#,#,#,#,#,#,#,#,#,#,#,#,#,#,#,#,*,*,*,#
#,*,*,*,*,*,#,#,#,#,#,#,*,*,*,*,*,*,*,#,*,*,*,*,*,*,*,*,*,*,*,*,*,*,*,*,*,*,*,*,*,*,*,#,*,*,*,#
#,*,*,*,*,*,*,*,*,*,*,*,*,*,*,*,*,*,*,#,*,*,*,*,*,*,*,*,*,#,*,*,*,*,*,*,*,*,*,*,*,*,*,#,*,*,*,#
#,*,*,*,*,*,*,*,*,*,*,^,*,*,*,*,*,#,#,#,*,*,*,*,*,*,*,*,*,*,*,*,*,*,*,*,*,*,*,*,#,#,#,#,*,*,*,#
#,*,*,O,*,*,*,*,*,*,*,*,*,*,*,*,*,#,*,#,#,#,#,#,#,#,#,#,#,#,#,#,#,#,#,#,#,#,#,#,#,*,*,#,*,*,*,#
#,*,*,*,*,*,*,*,*,*,*,*,*,*,*,*,*,#,*,*,*,#,*,*,*,#,*,*,^,*,*,*,*,*,#,*,*,*,*,*,*,*,*,#,!,*,*,#
#,#,#,#,#,#,#,#,#,#,#,#,#,#,#,#,#,#,#,#,#,#,#,#,#,#,#,#,#,#,#,#,#,#,#,#,#,#,#,#,#,#,#,#,#,#,#,#
